{ 
"width": 12, 
"height": 12, 
"startX": 0, 
"startY": 2, 
"startDir": "right", 
"endX": 10, 
"endY": 11, 
"data": [1, 1, 1, 1, 1, 1, 1, 1, 1, 1, 1, 1,
		1, 0, 1, 1, 0, 1, 1, 0, 1, 1, 0, 1,
		1, 0, 1, 1, 1, 1, 1, 0, 1, 1, 1, 1,
		0, 1, 1, 0, 1, 1, 1, 1, 1, 0, 1, 1,
		1, 0, 1, 1, 1, 1, 1, 0, 1, 1, 1, 1,
		1, 1, 1, 1, 1, 1, 1, 1, 1, 1, 1, 1,
		1, 1, 1, 1, 1, 1, 1, 1, 1, 1, 1, 1,
		1, 0, 1, 1, 0, 1, 1, 0, 1, 1, 0, 1,
		1, 0, 1, 1, 1, 1, 1, 0, 1, 1, 1, 1,
		1, 1, 1, 0, 1, 1, 1, 1, 1, 0, 1, 1,
		1, 0, 1, 1, 1, 1, 1, 0, 1, 0, 0, 1,
		1, 1, 1, 1, 1, 1, 1, 1, 0, 1, 1, 1],
"numFunctions": 2, 
"functionLimit": [5,5],
"totalMoves": 8
}