{ 
"width": 9, 
"height": 9, 
"startX": 8, 
"startY": 8, 
"startDir": "left", 
"endX": 0, 
"endY": 1, 
"data": [0, 0, 1, 1, 1, 1, 1, 1, 1,
		1, 1, 1, 0, 0, 0, 1, 0, 1,
		1, 1, 0, 0, 0, 0, 1, 1, 0,
		0, 1, 1, 0, 0, 0, 0, 1, 0,
		1, 0, 1, 0, 0, 0, 0, 1, 0,
		1, 1, 1, 1, 0, 0, 0, 1, 1,
		1, 0, 0, 0, 1, 1, 1, 0, 1,
		1, 0, 1, 1, 1, 0, 1, 0, 1,
		1, 1, 1, 0, 1, 0, 1, 1, 1],
"numFunctions": 3, 
"functionLimit": [6,3,3],
"totalMoves": 6
}

1 1 1 l 1 1
1 - r f f f l f